1111111111
1E100C1111
1000011P11
1010C01111
1111111111